. . . . . . . . . .
. . . . . . . 0 . .
. 1 . . . . . . . .
. . . . . . X . . .
. . . X . . . 0 . .
. . . . . . . . . .
. . X . . . X . . .
. 1 . . . . . . . .
. . . . . . . . . .
. . . . . . . . . .
