. . . X . . . . . . . . . . . . . . . . . . . . . . . . . . . . . . . . . . . .
. . X . . . . . . . . . . . . . . . . . . . . . . . . . . . . . . . X X . . . .
. . . . . . . . . . . . . . . . . . . . . . . . . . . . . . . . . . . X X . . .
. X X X X X X X X X X X X X X X X X X X X X X X X X X X X X X X X X X X X X X .
. . . . . . . . . . . . . . . . . . . . . . . . . . . . . . . . . . . . . X X .
. . . . . . . . . . . . . . . . . . . . . . . . . . . . . . . . . . . . . . X X
. . . . . . . . . . . . . . . . . . . . . . . 0 . . . . . . . . . . . . . . . X
. . . . . . . . . . . . . . . . . . . . . . . . . . . . . . . . . . 1 . . . . .
. . . . . . . . . . . . . . . . . . . . . . . . . . . . . . . . . . . . . . . .
. . . . . . . . . . . . . . . . . . . . . . . . . . . . . 1 . . . . . . . . . .
. . . . . . . . . . . . . . . . . . . . . . . . . . . . . 0 . . . . . . . . . .
. . . . . . . . . . . . . . . . . . . . . . . . . . . . . . . . . . . . . . . .
. . . . . . . . . . . . . . . . . . . . . . . . . . . . . . . . . . 0 . . . . .
. . . . . . . . . . . . . . . . . . . . . . . 1 . . . . . . . . . . . . . . . X
. . . . . . . . . . . . . . . . . . . . . . . . . . . . . . . . . . . . . . X X
. . . . . . . . . . . . . . . . . . . . . . . . . . . . . . . . . . . . . X X .
. X X X X X X X X X X X X X X X X X X X X X X X X X X X X X X X X X X X X X X .
. . . . . . . . . . . . . . . . . . . . . . . . . . . . . . . . . . . X X . . .
. . X . . . . . . . . . . . . . . . . . . . . . . . . . . . . . . . X X . . . .
. . . X . . . . . . . . . . . . . . . . . . . . . . . . . . . . . . . . . . . .

