. . . . . . . . . . . . . . . . . . . . . . . . . . . . . . . . . . . . . . . .
. . . . X . . . . . . . . . . . . . . . . . . . X . . . . . . X . . . X . . . .
. . . . X . . . . . . . . . . . . . . . . . . . . X . . . . . . X . . X . . . .
. . . . X . . . . . . . . 1 . . . . . . . . . . . . X . . . . . . X . . . . . .
. X . . X . . . . . . . . . . . . . . . . . . . . . . X . . . . . . X X . . . 1
. . X . . . . . . . . . . . . . . . . . . . . . . . . . X . . . . . . X . . . .
. . . X X . . . . . . . . . 1 . . . . . . . . . . . . . . X . . . . . X X . . .
. . . . . . . . . . . . . . . . . . . . . . . . . . . . . . X . . . . . . . . .
. X X X X X X X X X X X X X X X X X X X X X X X X X X X X X X X X X X X X X . X
. . . . . . . . . . . . . . . . . . . . . . . . . . . . . . . . . . . . . . . X
X . . . . . . . . . . . . . . . . . . . . . . . . . . . . . . . . . . . . . . .
X . X X X X X X X X X X X X X X X X X X X X X X X X X X X X X X X X X X X X X .
. . . . . . . . . X . . . . . . . . . . . . . . . . . . . . . . . . . . . . . .
. . . X X . . . . . X . . . . . . . . . . . . . . 0 . . . . . . . . . X X . . .
. . . . X . . . . . . X . . . . . . . . . . . . . . . . . . . . . . . . . X . .
0 . . . X X . . . . . . X . . . . . . . . . . . . . . . . . . . . . . X . . X .
. . . . . . X . . . . . . X . . . . . . . . . . . . 0 . . . . . . . . X . . . .
. . . . X . . X . . . . . . X . . . . . . . . . . . . . . . . . . . . X . . . .
. . . . X . . . X . . . . . . X . . . . . . . . . . . . . . . . . . . X . . . .
. . . . . . . . . . . . . . . . . . . . . . . . . . . . . . . . . . . . . . . .

