. . . . . . . . . . . . . . . . . . . . . . . . . . . . . . . . . . . . . . . .
. . . X . . . . . . . . . . . . . . . . . . . . . . . . . . . . . . . . X . . .
. . . X . . . . . . . . . . . . . . . . . . . . . . . . . . . . . . . . X . . .
. . . X . . . . . . . . . . . . . . . . . . . . . . . . . . . . . . . . X . . .
. . . X . . . . . . . . . . . . . . . . . . . . . . . . . . . . . . . . X . . .
. X . X . . . . . . . . . . . . . . . . . . . . . . . . . . . . . . . . X . X .
. . X X . . . 0 . . . . . . . . . . . . . . . . . . . . . . . . 1 . . . X X . .
. . . . . . . . . . . . . . . . . . . . . . . . . . . . . . . . . . . . . . . .
. . . X X . . . . 0 . . . . . . . . . . . . . . . . . . . . 1 . . . . X X . . .
. . . . . X . . . . . . . . . . . . . . . . . . . . . . . . . . . . X . . . . .
. . . X . . X . . . . . . . . . . . . . . . . . . . . . . . . . . X . . X . . .
. . . X . . . X . . . . . . . . . . . . . . . . . . . . . . . . X . . . X . . .
. . . X . . . . X . . . . . . . . . . . . . . . . . . . . . . X . . . . X . . .
. X . X . . . . . X . . . . . . . . . . . . . . . . . . . . X . . . . . X . X .
. . X X . . . . . . X 0 . . . . . . . . . . . . . . . . 1 X . . . . . . X X . .
. . . . . . . . . . . X . . . . . . . . . . . . . . . . X . . . . . . . . . . .
. X . X X . . . . . . . X . . . . . . . . . . . . . . X . . . . . . . X X . X .
. . X X . X . . . . . . . X . . . . . . . . . . . . X . . . . . . . X . X X . .
. . . . . . X . . . . . . . X . . . . . . . . . . X . . . . . . . X . . . . . .
. . . X X . . . . . . . . . . . . . . . . . . . . . . . . . . . . . . X X . . .

